| 2| 1|
| 5| 2|
| 7| 3|
| 8| 4|
| 9| 3|
| 10| 4|
| 11| 5|
| 12| 5|
| 13| 4|
| 14| 4|
| 15| 3|
| 16| 9|
| 17| 3|
| 18| 4|
| 19| 2|
| 20| 3|
| 21| 5|
| 22| 4|
| 23| 3|
| 24| 7|
| 25| 2|
| 26| 1|
| 27| 4|
| 28| 2|
| 29| 3|
| 31| 6|
| 32| 2|
| 33| 2|
| 34| 1|
| 35| 1|
| 36| 2|
| 37| 4|
| 38| 1|
| 40| 2|
| 41| 1|